# P # # # # # # # # # # # # # # # # # #
# P P P P P F - - - - - - - - - - - # #
# # # # # P # # - # # - # # # - # - - #
# - # # # P # - - # # - # # - - # - # #
# - # - F P # # # # # # # # # - # - - #
# - - - # P P P P # F # # F # F # # # #
# F # # # # V # P P P P P P P P P P F #
# V # # V V V # # # # # # # # # # P # #
# V V V V # V V # # - - - - - - F P P #
# # # # # # # # # # # # # # # # # # P #
