# P # # # # # # # # # # # # # # # # # #
# P P P P P V V V V V V V V V V V V # #
# # # # # P # # V # # V # # # V # V V #
# - # # # P # F V # # V # # F V # V # #
# - # - F P # # # # # # # # # V # V V #
# - - - # P P P P # F # # F # V # # # #
# - # # # # V # P P P P P P P P P P V #
# - # # - F V # # # # # # # # # # P # #
# - - - - # V V # # - - - - - - F P P #
# # # # # # # # # # # # # # # # # # P #
